  +---------------------------+                               
  |...........................|                               
  |...........................#########################       
  |...........................|                       #       
  +-------------#-------------+                       #       
                #                                     #       
  +---------+   #      +------------------+           #       
  |.........############..................|          +#------+
  |.........|          |..................|          |.......|
  |.........|          +------------------+          |.......|
  +---------+                                      ###.......|
                 ################################### +-------+
            ######                                            
  +---------#--+ ############################################ 
  |............|                                            # 
  |............|   +--------------------+                   # 
  |............|   |....................##################### 
  +------------+   |....................|                     
                  ##....................#######               
                   |....................|     #               
  +------------+   +--------------------+     # +-----------+ 
  |............|                              # |...........| 
  |............##################################...........| 
  |............|                                +-----------+ 
  +------------+                                              
